1111111111
1000100001
1000000101
1010100101
1010000001
1010100101
1000000001
1001010001
1001010101
1000010001
1001000101
1001011001
1001000001
10101100$1
1111111111